111111111111111111111111111
100000000000000000000000001
100000000000000000000000001
100000000000000000000000001
100000000000000000000000001
100000000000010000000000001
100000111100010001111000001
100000100000010000001000001
100000100000000000001000001
100000100000000000001000001
100000000000111000000000001
100000000000000000000000001
100000000010000010000000001
100001110010010010011100001
100000000010000010000000001
100000000000000000000000001
100000000000111000000000001
100000100000000000001000001
100000100000000000001000001
100000100000010000001000001
100000111100010001111000001
100000000000010000000000001
100000000000000000000000001
100000000000000000000000001
100000000000000000000000001
100000000000000000000000001
111111111111111111111111111
